




111111
1100001111
1111111
